350 250
15 2
10 1
6 6

0 1 0 1 0 0
1 0 0 1 0 0
0 1 0 1 1 1
1 0 1 0 0 1
0 1 0 1 1 0
1 0 1 0 1 1

0 0 0 0 0 0
1 0 0 1 0 0
0 1 0 1 1 1
1 0 1 0 0 1
0 1 0 1 1 0
1 0 1 0 1 1




